20 15
2 2 2 2 2 2 2 2 2 2 2 2 2 2 2 2 2 2 2 2
2 1 1 1 1 1 1 1 1 2 1 1 1 1 1 1 1 1 1 2
2 1 2 2 2 2 1 2 1 1 1 2 2 2 1 2 2 2 1 2
2 1 2 1 2 1 1 2 1 2 1 2 1 2 1 2 1 1 1 2
2 2 2 1 2 1 2 2 1 1 1 2 1 1 1 2 1 2 1 2
2 1 1 1 1 1 1 1 2 2 1 2 1 2 2 2 1 2 1 2
2 2 2 2 2 2 2 1 1 2 1 1 1 2 1 1 1 2 2 2
2 1 1 1 1 1 2 1 2 2 1 2 1 2 2 2 1 1 1 2
2 1 2 1 2 1 2 1 1 2 1 2 1 1 1 2 2 2 1 2
2 2 2 1 2 2 2 2 1 1 1 2 2 2 1 1 1 1 1 2
2 1 1 1 1 1 1 1 1 2 1 1 1 2 2 1 2 2 2 2
2 1 2 2 2 1 2 2 2 2 1 2 2 2 1 1 1 2 1 2 
2 1 2 1 2 1 2 1 1 1 1 2 1 2 1 2 2 2 1 2 
2 1 1 1 1 1 1 1 2 1 1 1 1 1 1 1 1 1 1 2
2 2 2 2 2 2 2 2 2 2 2 2 2 2 2 2 2 2 2 2

32 32

1
96 96 384 96 384 384 576 416
